555555555
544445445
534445305
544444445
545855945
525444445
555555555