555555555
524444345
555554445
544434485
545444445
505444945
555555555