555555555
544445445
534485325
544444445
545455445
505444945
555555555