555555555
504444445
555534485
543444445
544555555
549444425
555555555